....................
.....__.............
.........__....__|..
.__...-.....--|..|..
......|.......|..|..
......|..|....|..|..
......|..|__.__..|..
.........|..........
....___.............
...............s..e.
--------------------