....................................................................................|...........................................
....................................................................................|....................................x......
..................................................................__...__....__.....|...|___.................__...__....___.....
..............................__.......__.....................__...............-....|...|..............__.......................
.+.....................................-......................-................-........|.......................................
--------------------------------------------------------------------------------------------------------------------------------