....................
..|.._._._._._._.__.
..|.|...............
..|.|...............
..|.|....._._._..__.
..__.__.............
.................__.
.e....s...__..__....
.__.__.__...........
....................
....................