.....................................................................................|................................-----------
.....................................................................................|...|.................................|....|
.....................................|......__........__........__.__.__.__.__.__....|...|..................__.......__.|..|..|.|
..............................__.....|..__.......__........__....................-.......|..............__.......__.....|..|..|.|
.+...................................|...........................................-.......|..............................|.....|x|
---------------------------------------------------------------------------------------------------------------------------------