....................
....................
....................
....................
......|__...........
......|..|..........
......|..|...__.-...
.........|......-...
....___.........-...
................-...
--------------------