....................
...._..........._..|
.|.|.............|.|
.|.|.............|.|
.................|.|
.._._._._._._._._|.|
.................|.|
....s..........--|.|
.__._._._...........
.e........_._._._._.
.--.................