....................
|.._p......_._._..|.
|.|.............|.|.
|.|.............|.|.
|.|.._._._._._._._..
._..................
....................
.._._._._._._._._...
.................._.
e.s.................
____________________