....................
.p____........_._...
.................._.
.._.................
....._.._.._._...._.
....................
.................._.
...._.._.._.._......
..._.............._.
..s...............e.
____________________