....................
|.._......._._._..|.
|.|.............|.|.
|.|.............|.|.
|.|....._.......|...
.................__.
._.._.._............
.................._.
....................
e...s............._.
____________________