....................
.p____........_._...
.................._.
.._.................
.................._.
..__.|..............
...|.............._.
...._.._.._.._......
.................._.
e.s.................
____________________