 ....................
...._.._.._.._.._...
.._.................
_................._.
......-.._.._.._....
.._...-.............
......-_............
._....-..._.._.._p..
..._..-_............
..s...-...........e.
____________________